 1.71293375394322e+001    1.45741324921136e+001
 1.66561514195584e+001    1.50473186119874e+001
 1.55205047318612e+001    1.54258675078864e+001
 1.44794952681388e+001    1.55205047318612e+001
 1.38170347003155e+001    1.55205047318612e+001
 1.31545741324921e+001    1.52365930599369e+001
 1.25867507886435e+001    1.49526813880126e+001
 1.24921135646688e+001    1.44794952681388e+001
 1.24921135646688e+001    1.39116719242902e+001
 1.26813880126183e+001    1.33438485804416e+001
 1.30599369085174e+001    1.28706624605678e+001
 1.34384858044164e+001    1.23974763406940e+001
 1.39116719242902e+001    1.21135646687697e+001
 1.46687697160883e+001    1.19242902208202e+001
 1.54258675078864e+001    1.19242902208202e+001
 1.61829652996845e+001    1.20189274447950e+001
 1.68454258675079e+001    1.24921135646688e+001
 1.71293375394322e+001    1.31545741324921e+001
 1.71293375394322e+001    1.40063091482650e+001
 1.71293375394322e+001    1.45741324921136e+001
