 1.69400630914826e+001    1.76637726913970e+001
 1.55205047318612e+001    1.79479084451460e+001
 1.40063091482650e+001    1.82320441988950e+001
 1.25867507886435e+001    1.86108918705604e+001
 1.10725552050473e+001    1.87056037884767e+001
 9.65299684542587e+000    1.87056037884767e+001
 8.61198738170347e+000    1.83267561168114e+001
 7.76025236593060e+000    1.77584846093133e+001
 7.09779179810726e+000    1.70007892659826e+001
 7.38170347003155e+000    1.59589581689029e+001
 8.61198738170347e+000    1.48224151539069e+001
 9.84227129337539e+000    1.37805840568272e+001
 1.07886435331230e+001    1.29281767955801e+001
 1.17350157728707e+001    1.20757695343331e+001
 1.26813880126183e+001    1.13180741910024e+001
 1.37223974763407e+001    1.08445146014207e+001
 1.46687697160883e+001    1.05603788476717e+001
 1.58044164037855e+001    1.05603788476717e+001
 1.67507886435331e+001    1.07498026835043e+001
 1.76025236593060e+001    1.12233622730860e+001
 1.83596214511041e+001    1.17916337805841e+001
 1.89274447949527e+001    1.22651933701657e+001
 1.89800210304942e+001    1.23072875559063e+001
 1.93690851735016e+001    1.29492238884504e+001
 2.01577287066246e+001    1.52012628255722e+001
 2.00946372239748e+001    1.59589581689029e+001
 1.97791798107256e+001    1.65272296764010e+001
 1.87381703470031e+001    1.72849250197317e+001
 1.69400630914826e+001    1.76637726913970e+001
 1.55205047318612e+001    1.79479084451460e+001
 